11111111111111111111111
1P0000000110001100000C1
10110111101101101111101
1C110111101101101111101
10110111101101101111101
10000C1100000M0001111C1
10110111111101101111101
10110111111101101111101
100M000000C001100000C01
10110111101101101111101
10110111101101100111101
10000C110000000001111C1
10110111111101101111101
1C110111111101101111101
1000000000M001100000E01
11111111111111111111111
